[
    {
        "index": 0,
        "data": [
            {"x": 3, "y": 3, "z": 2},
            {"x": 6, "y": 3, "z": 2},
            {"x": 9, "y": 3, "z": 2},
            
            {"x": 3, "y": 4, "z": 1},
            {"x": 6, "y": 4, "z": 1},
            {"x": 9, "y": 4, "z": 1},
            
            {"x": 3, "y": 5, "z": 0},
            {"x": 6, "y": 5, "z": 0},
            {"x": 9, "y": 5, "z": 0}
        ]
    },
    {
        "index": 1,
        "data": [
            {"x": 7, "y": 7, "z": 10},
            {"x": 6, "y": 6, "z": 9},
            {"x": 5, "y": 5, "z": 8},
            {"x": 6, "y": 6, "z": 7},
            {"x": 7, "y": 7, "z": 6},
            {"x": 6, "y": 6, "z": 5},
            {"x": 7, "y": 7, "z": 4},
            {"x": 6, "y": 6, "z": 3},

            {"x": 5, "y": 5, "z": 2},
            {"x": 9, "y": 6, "z": 2},
            {"x": 3, "y": 6, "z": 2},
            {"x": 6, "y": 9, "z": 2},
            {"x": 6, "y": 3, "z": 2},
            {"x": 7, "y": 7, "z": 2},
            {"x": 5, "y": 7, "z": 2},
            {"x": 7, "y": 5, "z": 2},
            {"x": 5, "y": 5, "z": 2},

            {"x": 8, "y": 6, "z": 1},
            {"x": 4, "y": 6, "z": 1},
            {"x": 6, "y": 8, "z": 1},
            {"x": 6, "y": 4, "z": 1},
            {"x": 6, "y": 6, "z": 1},

            {"x": 0, "y": 4, "z": 1},
            {"x": 3, "y": 2, "z": 1},
            {"x": 6, "y": 0, "z": 1},
            {"x": 9, "y": 2, "z": 1},
            {"x": 12, "y": 4, "z": 1},

            {"x": 0, "y": 8, "z": 1},
            {"x": 3, "y": 10, "z": 1},
            {"x": 6, "y": 12, "z": 1},
            {"x": 9, "y": 10, "z": 1},
            {"x": 12, "y": 8, "z": 1},

            {"x": 0, "y": 4, "z": 0},
            {"x": 3, "y": 2, "z": 0},
            {"x": 6, "y": 0, "z": 0},
            {"x": 9, "y": 2, "z": 0},
            {"x": 12, "y": 4, "z": 0},

            {"x": 0, "y": 8, "z": 0},
            {"x": 3, "y": 10, "z": 0},
            {"x": 6, "y": 12, "z": 0},
            {"x": 9, "y": 10, "z": 0},
            {"x": 12, "y": 3, "z": 0}
        ]
    }
]